2 2 2 2 2 2 2 2 2 2 2 2 2 2 2 2 2 2 2 2 2 2 2 2 2 2 2 2
2 0 0 0 0 0 0 0 0 0 0 0 0 5 5 0 0 0 0 0 0 0 0 0 0 0 0 2
2 0 0 0 0 0 4 4 0 0 2 0 0 5 5 0 0 2 0 4 4 4 0 0 3 4 0 2
2 0 0 0 0 0 0 4 0 0 0 0 0 6 6 0 0 0 0 4 4 0 0 0 3 4 0 2
2 0 3 3 3 2 0 0 0 0 2 0 0 5 5 0 0 2 0 0 0 0 2 0 0 0 0 2
2 0 0 0 0 2 0 0 0 0 0 0 0 5 5 0 0 0 0 0 0 0 2 0 0 0 0 2
2 0 0 0 0 2 0 0 0 0 2 0 0 5 5 0 0 2 0 0 0 0 2 0 0 0 0 2
2 0 1 0 0 0 0 0 0 0 0 0 0 5 5 0 0 0 0 0 0 0 0 0 0 0 0 2
2 0 0 0 0 0 0 0 0 0 2 0 0 5 5 0 0 2 0 0 0 0 0 0 0 0 0 2
2 0 0 0 0 0 0 0 0 0 0 0 0 5 5 0 0 0 0 0 0 0 0 0 0 0 0 2
2 0 0 0 0 2 0 0 0 0 2 0 0 5 5 0 0 2 0 0 0 0 2 0 0 0 0 2
2 0 0 0 3 2 0 0 0 0 0 0 0 5 5 0 0 0 0 0 0 0 2 3 0 0 0 2
2 0 0 3 3 2 0 0 0 0 2 0 0 5 5 0 0 2 0 0 0 0 2 3 3 3 0 2
2 0 0 0 0 0 0 0 0 0 0 0 0 5 5 0 0 0 0 0 0 0 0 0 0 0 0 2
2 0 0 0 0 0 4 4 0 0 2 0 0 6 6 0 0 2 0 0 4 0 0 0 270 0 0 2
2 0 0 0 0 4 4 0 0 0 0 0 0 5 5 0 0 0 0 0 4 4 0 0 270 0 0 2
2 0 0 0 0 0 0 0 0 0 0 0 0 5 5 0 0 0 0 0 0 0 0 0 0 0 0 2
2 2 2 2 2 2 2 2 2 2 2 2 2 2 2 2 2 2 2 2 2 2 2 2 2 2 2 2

/*
0=grass
1=tank
2=beton
3=brick
4=tree
5=water
6=woodenPlate
*/