2 2 2 2 2 2 2 2 2 2 2 2 2 2 2 2 2 2 2 2 2 2 2 2 2 2 5 5
2 0 0 0 2 0 0 0 0 0 0 0 0 0 0 0 0 0 0 0 0 0 0 5 5 5 5 5
2 0 1 0 2 0 3 4 4 0 0 0 0 4 0 4 0 0 0 0 0 0 0 5 5 5 5 2
2 0 2 0 2 0 3 0 5 5 5 0 0 0 4 0 0 0 0 0 0 0 5 5 5 5 0 2
2 0 0 0 0 0 0 0 5 5 5 0 0 0 0 0 0 0 0 0 0 5 5 5 5 0 0 2
2 3 3 3 3 3 3 0 5 5 5 0 0 0 0 0 0 0 0 0 5 5 5 5 0 0 0 2
2 0 0 0 0 0 0 0 0 0 0 0 0 0 0 0 0 0 0 5 5 5 5 0 0 0 0 2
2 0 0 0 0 0 0 0 4 0 0 0 0 0 0 0 0 5 5 5 5 5 0 0 0 0 0 2
2 0 0 0 0 0 0 0 0 0 0 0 0 0 0 0 5 5 5 5 0 0 0 0 0 0 0 2
2 0 0 0 4 0 0 0 0 0 0 0 0 0 0 0 5 5 0 0 4 0 0 0 0 0 0 2
2 0 0 0 0 0 0 2 2 2 0 0 0 0 0 5 5 5 0 4 0 0 0 0 0 0 0 2
2 0 0 0 0 0 0 2 5 2 0 0 0 0 5 5 5 0 0 4 0 0 0 0 0 0 0 2
2 0 0 0 0 0 0 2 2 2 0 0 0 5 5 5 0 0 4 0 0 0 0 0 0 0 0 2
2 2 2 2 2 0 0 0 0 0 0 5 5 5 5 5 0 0 0 0 0 0 0 0 0 0 0 2
2 0 0 0 0 0 0 0 0 0 5 5 5 5 5 0 0 0 0 0 0 0 0 0 6 0 0 2
2 0 0 0 2 0 0 0 5 5 5 5 5 0 0 0 0 0 0 0 0 0 0 0 0 0 0 2
2 0 0 0 0 0 0 5 5 5 5 5 0 0 0 0 0 0 0 0 0 0 0 0 0 0 0 2
2 2 2 2 2 5 5 5 5 2 2 2 2 2 2 2 2 2 2 2 2 2 2 2 2 2 2 2

/*
0=grass
1=tank
2=beton
3=brick
4=tree
5=water
6=bot
*/